8,8,,,,,,
,,,,,,
-,-,-,-,-,-,-,-
-,^,^,-,^,^,-,-
-,~,~,-,~,~,-,-
-,~,~,-,~,~,-,-
-,-,-,-,-,-,-,-
-,~,-,-,-,~,-,-
-,-,~,~,~,-,-,-
-,-,-,-,-,-,-,-