20,20,,,,,,,,,,,,,,,,,,
,,,,,,,,,,,,,,,,,,,
-,^,^,^,^,^,~,~,~,~,-,-,-,-,-,-,-,-,-,-
-,-,^,^,~,~,~,~,^,^,-,-,-,-,-,-,-,-,-,-
-,-,^,^,~,~,~,^,^,^,-,-,-,-,-,-,-,-,-,-
-,-,^,~,~,~,^,^,^,-,-,-,-,-,-,-,-,-,-,-
-,-,^,^,^,-,-,-,-,-,-,~,~,~,~,~,~,~,~,~
-,-,^,^,^,-,-,-,-,-,-,~,~,~,~,~,~,~,~,~
-,-,^,^,^,-,-,-,-,-,-,~,~,-,-,-,-,-,~,~
-,-,^,^,^,-,-,-,-,-,-,~,~,-,-,-,-,-,~,~
-,-,-,~,~,-,-,-,-,~,~,~,~,-,-,-,-,-,~,~
-,-,^,^,^,-,-,-,~,~,~,~,~,~,~,~,~,~,~,~
-,-,^,^,^,-,-,~,~,~,~,~,~,~,~,~,~,~,~,~
-,-,^,^,~,~,~,^,^,^,-,-,-,-,-,-,-,-,-,-
-,-,^,^,~,~,~,~,^,^,-,-,-,-,-,-,-,-,-,-
-,-,^,^,~,~,~,^,^,^,-,-,-,-,-,-,-,-,-,-
-,-,-,-,-,~,-,-,-,-,-,-,-,-,-,-,-,-,-,-
~,-,-,-,-,-,-,-,-,-,-,-,-,-,-,-,-,-,-,-
~,-,-,-,-,-,-,-,-,-,-,-,-,-,-,-,-,-,-,-
~,~,~,~,-,-,-,-,-,-,-,-,-,-,-,-,-,-,-,-
~,~,^,~,-,-,-,-,-,-,-,-,-,-,-,-,-,-,-,-
~,^,^,^,-,-,-,-,-,-,-,-,-,-,-,-,-,-,-,-
^,^,^,^,-,-,-,-,-,-,-,-,-,-,-,-,-,-,-,-