10,10

-,^,^,^,^,^,~,~,~,~
-,-,^,^,~,~,~,~,^,^
-,-,^,^,~,~,~,^,^,^
-,-,^,~,~,~,^,^,^,-
-,-,-,-,-,-,-,-,-,-
-,-,-,-,-,-,-,-,-,-
-,-,-,-,-,-,-,-,-,-
-,-,-,-,-,-,-,-,-,-
-,-,-,-,-,-,-,-,-,-
-,-,-,-,-,-,-,-,-,-
